#,#,#,#,#,#,#,#,#,#,#,#,#,#,#,#,#,#,#,#,#,#,#,#,#
#,Y, , , , , , , , , , , , , , , , , , , , , , ,#
#, , , , , , , , , , , , , , , , , , , , , , , ,#
#, , , , , , , , , , , , , , , , , , , , , , , ,#
#, , , , , , , , , , , , , , , , , , , , , , , ,#
#, , , , , , , , , , , , , , , , , , , , , , , ,#
#, , , , , , , , , , , , , , , , , , , , , , , ,#
#, , , , , , , , , , , , , , , , , , , , , , , ,#
#, , , , , , , , , , , , , , , , , , , , , , , ,#
#,#,#,#,#,#,#,#,#,#,#,#,#,#,#,#,#,#,#,#,#,#,#,#,#
